---#--###----
-#---#----##-
####-#-#-#-##
---#---#-#---
-#-####---##-
-#------#----
-############
------------@